15 15
8 13
3 4
13 12
111111111111111
100000222000001
101010121010101
100000020000001
101010121010141
100002220220441
121210121212141
100000000002001
101010101010101
100022220000001
101210121010101
100000000022001
101010101210101
100000222200001
111111111111111
