15 15
5 7
3 5
11 6
111111111111111
100000222000001
101010101010101
100000000000001
101010101010101
100002000000001
121210101010101
100020000000001
101010101010101
100022220000001
101210121010101
100000000022001
101010101210101
100000222200001
111111111111111
