15 15
4 11
2 1
9 12
111111111111111
100000222000001
101010121010101
100000020000001
101010121010101
100002220220001
121210121212101
100020000002001
101010101010101
100022220000001
101210121010101
100000000022001
101010101210101
100000222200001
111111111111111
