11 11
1 9
4 1
9 4
11111111111
10000000001
10101010101
10000000001
10101010101
10000000001
10101010101
10000000001
10101010101
10000000001
11111111111